19 11
* * * * * * * * * * * * * * * * * * *
* 0 B 0 0 B 0 0 0 B 0 0 0 B 0 0 B 0 *
* 0 0 B 0 0 B 0 0 B 0 0 B 0 0 B 0 0 *
* W 0 0 B 0 0 T T T T T 0 0 B 0 0 W *
* W 0 0 0 B 0 T S S S T 0 B 0 0 0 W *
* S S S S S B T T T T T B S S S S S *
* W 0 0 0 B 0 0 B 0 B 0 0 B 0 0 0 W *
* W 0 0 B 0 0 B 0 B 0 B 0 0 B 0 0 W *
* 0 0 B 0 0 B B 0 B 0 0 B 0 0 B 0 0 *
* 0 B 0 0 B P B E B 0 0 0 B 0 0 B 0 *
* * * * * * * * * * * * * * * * * * *